+----------------------------------------------------------+
|                                                          |
|  S                            +----------------+         |
|     +-------------------------+                |         |
|     |                                          |         |
|     |                                                    |
|     |                         ---------+                 |
|     |                                  |       |         |
|                                        |       |         |
|                                        |       |         |
|     |                                  |       +----+    |
|     +--------------+------             +---         |    |
|                    |                                     |
|                    |                                     |
|                    |      +---------------+--------+     |
|    ----------+            |               |        |     |
|              |            |               |              |
|              |            |               |              |
|              |      ------+               |              |
|                                                          |
+----------------------------------------------------------+